Gs, Gs, Gs, Gs, Gs, Gs, Gs, Gs, Gd, Gd, Gd, Gd, Gs, Gs, Gs, Gs, Gs^Efm, Re, Gs
Gd, Gs, Gs, Gs^Efm, Gs^Efm, Gs, Gs, Gs, Gd, Gd, Gd, Gd, Gs, Gs, Gs, Gs, Re, Re, Gs
Gs, Gd, Gd, Gs^Efm, Gd, Gs, Gs, Gs^Vct, Gs, Gd^Efm, Gd^Efm, Gd, Gd, Gs, Ce, Ce, Ce, Gs, Gs
Gd, Gd, Gd, Gd, Gd, Gs, Gs, Gs, Gs, Gs, Gs^Edb, Gd, Gd, Re, Ce, 4 Ke, Ce, Gd, Gd
Gs, Gd, Gd, Hhd, Hhd, Gd, Gd, Gd, Gs, Gs, Gs, Gd, Gd, Re, Re, Ce, Re, Gs, Gs
Gs, Gs, Gs, Gd, Gd, Gd, Gd, Gs, Gs^Fms, Gs, Gd, Gs, Gs, Gs, Gs, Gs, Gs, Gs, Gs
Gs, Gs, Gs^Efm, Gd, Gs, Gd, Gd, Gs, Ww, Gs, Gd, Gd, Gd, Gs, Gd, Gs, Gs, Gs, Gs
Gs, Gs, Gs^Efm, Gs^Vct, Gs, Gs, Gs, Gd, Ww, Ww, Gs^Edb, Gd, Gd, Gd, Gd, Gd, Gs, Gs, Gs
Gs, Gs, Gs, Gs, Gs^Efm, Gs, Gs, Gs, Gs, Ww, Ww, Gs, Gd, Gd, Gd^Efm, Gd^Vct, Hhd, Gs, Gs
Gd, Gd, Gs, Gs, Gs, Gs, Gd, Gs, Gs, Gs, Gs, Gs, Gs, Gs, Gd, Hhd, Hhd, Gd, Gd
Gd, Gd, Re, Re, Re, Gs, Gs, Gd, Gd, Gd, Gd, Gd, Gd, Gd, Gd, Gd, Gd, Gd, Gd
Gd, Gd, Ce, Ce, Ce, Gs, Gs, Gs, Gd^Efm, Gd, Gd, Gd, Gs, Gd, Gd, Gs, Gs, Gd^Efm, Gs
Gs, Gs, Ce, 1 Ke, 2 Ce, Gs, Gs, Gs, Gs^Efm, Gd^Efm, Gd, Gd, Gs, Gs, Gs, Gs^Fms, Gs, Gs, Gs
Re, Gs, Re, 3 Ce, Re, Gs, Gs, Gs, Gs, Gd, Gd, Gs^Vct, Gs^Efm, Gs, Gs, Gs, Gs, Gs, Gs
Gs, Re, Gs, Gs, Gs, Gs, Gs, Gs, Gs, Gs, Gs, Gs, Gs, Gs, Gs, Gs, Gs, Gs, Gs
