Gll^Fp, Gs^Fms, Gs^Fms, Gll^Fp, Gs^Fms, Gs^Fms, Gll^Fms, Gll^Fms, Gll^Fms, Gg, Gll^Fms, Gll^Fp, Wo, Ww, Gs^Fms, Gs^Fms, Gll^Fp, Gll^Fp, Gll^Fp, Gs^Fms, Gll^Fp, Gll^Fp, Gll^Fms, Gs^Fms, Gll^Fp, Gll^Fp, Gs^Fms, Gll^Fms, Ww, Gs^Fms, Gs^Fms, Gs^Fms, Gs^Fms
Gs^Fms, Gll^Fp, Gg^Ve, Gll^Fp, Gs^Fms, Gs^Fms, Gs^Fms, Gll^Fp, Gll^Fp, Gll^Fp, Gs^Fms, Gll^Fms, Wo, Ww, Gll^Fp, Gll^Fdw, Gll^Fp, Gs^Fms, Gs^Fms, Gll^Fp, Gll^Fp, Gs^Fms, Gll^Fdw, Gll^Fp, Gll^Fms, Gll^Fms, Gll^Fms, Gll^Fp, Ww, Gll^Fp, Gs^Fms, Gll^Fp, Gll^Fp
Gll^Fp, Gll^Fdw, Gll^Fp, Gll^Fdw, Rp^Cov, Rp^Cov, Rp^Cov, Gll^Fp, Gs^Fms, Gg^Ve, Gll^Fp, Wo, Ww, Gs^Vl, Gs^Fms, Gll^Fp, Gs^Fms, Gs^Fms, Gs^Fms, Gll^Fp, Gs^Fms, Gll^Fp, Gll^Cov, Gll^Cov, Gll^Cov, Gll^Fp, Gll^Fp, Gs^Fms, Ww, Gs^Fms, Gll^Fp, Gll^Fp, Gll^Fms
Gll^Fp, Gll^Fp, Gll^Fp, Gll^Fdw, Rp^Cov, 5 Kv^Ve, Rp^Cov, Gll^Fms, Gll^Fdw, Gs^Fms, Ww, Wo, Ww, Gll^Fp, Ww, Gll^Fp, Ww, Gs^Fms, Gll^Fp, Gs^Fms, Gll^Fp, Gs^Fms, Gll^Cov, 4 Ket^Vl, Gll^Cov, Gll^Fp, Gs^Fms, Ww, Gll^Fp, Gs^Fms, Gs^Fms, Gs^Fms, Gll^Fp
Gs^Fms, Gs, Gll^Fp, Gll^Fp, Gll^Fp, Rp^Cov, Rp, Gll^Fp, Gll^Fp, Gll^Fp, Wo, Ww, Gs^Fms, Ww, Gs^Fms, Ww, Gs^Fms, Gs^Fms, Gs^Fms, Gg, Gg, Gll^Fp, Gll^Fp, Gll^Cov, Gs, Gll^Fp, Wo, Ww, Gll^Fp, Gll^Fp, Gs^Vl, Gs^Fms, Gll^Fp
Gll^Fp, Gll^Fp, Gll^Fp, Gll^Fp, Gll^Fp, Gll^Fp, Rp, Gg, Gll^Fp, Gs^Fms, Wo, Gs^Fms, Gs^Fms, Gll^Fdw, Gs^Fms, Gs^Fms, Gs^Fms, Gll^Fp, Gll^Fp, Gg, Gs^Fms, Gll^Fp, Gs^Fms, Gs, Gll^Fp, Gll^Fp, Wo, Gll^Fp, Gs^Fms, Gll^Fp, Gg, Gg, Gs^Fms
Gg, Gg, Gg^Es, Cv, Gg, Rp, Gg, Gg^Em, Ww, Wo, Gll^Fp, Gs^Fms, Gs^Fms, Gs^Fms, Gll^Fp, Ce^Vl, Gll^Fms, Gll^Fp, Wo, Gs^Fms, Wo, Gll^Fms, Ww, Ww^Bw|, Ww, Wo, Gll^Fdw, Gs^Fms, Gg, Gll^Fp, Gll^Fp, Gll^Fdw, Gg
Re, Re, Re, Re, Re, Re, Re, Gg, Ww, Ww, Gg^Em, Gll^Fms, Ce, Gs^Fms, Gg, Gs^Fms, Wo, Ww, Gg, Wo, Gg, Ww, Gg^Es, Gg^Em, Gg, Gs^Fms, Gll^Fms, Gg^Em, Gg^Em, Gg, Gll^Fdw, Gll^Fp, Gg
Gg, Gg, Gg, Gg, Hh, Gg, Ww, Ww^Bw\, Re, Gg, Gg, Gg, Gg, Gg, Gg, Ww, Gg, Gg, Ce, Gg, Gs^Fms, Gs^Fms, Gs^Vl, Gg, Gg^Es, Gg, Gg, Gg, Gg, Gg, Ce, Gg, Gs
Gg, Gg^Es, Hh, Hh, Hh, Ww, Gs, Gs, Re, Re, Gll^Fp, Gg, Gg^Es, Gg^Em, Ww, Ww, Gg, Gg, Gg, Gg, Gg, Gs^Fms, Gs, Gg, Gs, Ce, Gs, Gs^Efm, Gs^Efm, Gs, Gs, Gs, Gs
Gg, Gg, Hh, Mm, Ww, Ww, Hh, Gs, Re, Gll^Fp, Gll^Fp, Mm, Mm, Ww, Gg, Gg, Gg, Gs^Efm, Gs, Gs^Efm, Gs, Gs, Gs, Gs, Gs, Gs^Efm, Gs^Efm, Gs, Gd, Gs, Gd, Gs, Gs
Hh, Hh, Mm, Mm, Mm, Mm, Hh, Re, Hh, Hh, Mm, Mm, Hh, Mm, Gs, Gg, Gs, Gs^Efm, Gs, Gs, Gs, Gs, Gs, Gs, Gs^Efm, Gs, Gd, Gd, Gd, Gd^Es, Gs, Gd, Gd
Mm, Mm, Mm, Mm, Hh^Fp, Hh, Ch, Re, Gs^Es, Rp^Vhcr, Hh, Hh, Hh, Gs^Fp, Gs, Gs, Gs, Gs, Gs, Gs, Gd, Gd, Gd, Gs^Efm, 1 Gs, 2 Gs, Gd, Gd^Edt, Gd, Gd, Gd, Gd, Gd
Mm, Mm, Hh^Fp, Hh^Fp, Hh^Cov, Gs, Rp, Rp, Gs^Es, Gs^Es, Gs, Gs^Es, Gs, Ch, Gs^Es, Gs, Gs, Gs, Gs, Gs, Gd, Gd^Edt, Gd, Gd, Gd, 3 Gd^Edt, Gd, Gd, Re^Vct, Gd, Gd, Gd, Gd
Hh^Fp, Hh^Fp, Hh^Fp, Hh^Cov, 6 Kh^Vhc, Hh^Cov, Rp, Hh, Hh, Hh, Hh, Hh, Hh, Hh, Gs^Es, Gs, Gd, Gs, Re^Vct, Gs, Gd, Gd, Gd, Gd, Gd^Es, Gd, Gd^Es, Gd, Gd^Edt, Gd, Gd, Gd, Gd^Edt
Hh^Fp, Hh^Fp, Hh^Fp, Hh^Cov, Hh^Cov, Hh^Cov, Rp, Hh, Hh^Fp, Mm, Hh^Fp, Hh^Fp, Hh, Hh, Hh, Gd, Gd, Gd, Gd, Gd, Gd, Gd, Gd^Es, Gd^Es, Gd^Edt, Gd, Gd, Gd^Edt, Gd, Gd, Gd, Gd, Gd
Rp, Rp, Rp, Rp, Rp, Rp, Hh, Hh, Mm, Mm, Hhd, Hh, Hhd, Hh, Hhd, Gd, Gd, Gd, Gd, Gd, Gd, Gd^Es, Hhd, Hhd, Gd^Edt, Gd^Es, Gd, Gd, Gd, Gd, Hhd, Gd, Hhd
Ss, Ss, Ss, Ss, Ss, Hh, Hh^Fp, Mm, Mm, Mm, Hhd, Hhd, Hhd, Hhd, Gd, Gd, Gd, Gd, Gd, Gd, Gd, Hhd, Hhd, Hhd, Hhd, Gd^Edt, Gd, Gd, Gd^Cov, Gd^Edt, Hhd, Hhd, Hhd
Ss, Wo, Wo, Ss, Ss, Ss, Hh^Fp, Mm, Mm, Hhd, Hhd, Ch^Vhcr, Hhd, Gd^Es, Gd, Gd, Gd, 9 Gd, Gd, Gd, Gd, Hhd, Gd, Gd, Gd, Gd, Hhd, Gd^Cov, 7 Co^Ecf, Gd^Cov, Hhd, Hhd, Hhd
Ss, Wo, Ss, Mm, Mm, Mm, Mm, Mm, Hhd, Hhd, Mm, Hhd, Hhd, Hhd, Gd, Gd, Gd, Gd, Gd, Gd, Gd, Gd^Es, Co^Vct, Gd, Gd, Hhd, Hhd, Gd^Cov, Gd^Cov, Gd^Cov, Gd, Hhd, Gd
Gd, Ss, Rd, Hhd, Hhd, Mm, Hhd, Hhd, Hhd, Mm, Mm, Hhd, Hhd, Hhd, Gd, Gd, Gd, Gd, Gd^Edt, Gd, Gd^Es, Gd, Gd, Gd, Hhd, Hhd, Hhd, Rd, Gd, Gd, Gd, Gd, Gd
Gd, Gd, Gd, Rd, Rp^Vhcr, Hhd, Hhd, Hhd, Hhd, Hhd, Gd, Hhd, Gd, Gd, Re^Vct, Gd, Gd, Gd, Gd, Gd, Gd, Gd, Gd, Gd, Gd, Gd, Rd, Rd, Gd, Gd, Rd, Gd^Es, Rd
Hhd, Gd^Es, Hhd, Rd, Rd, Hhd, Gd, Hhd, Gd, Gd^Es, Gd, Gd, Gd, Gd, Gd, Gd, Gd, Gd, Gd, Gd, Gd^Es, Gd^Edt, Rd, Gd, Rd, Rd, Dd, Gd, Dd, Rd, Rd, Rd, Dd
Hhd, Hhd, Hhd, Gd, Ch, Rd, Gd, Gd, Hhd, Hhd, Gd, Gd, Gd^Es, Gd, Rd, Rd, Dd, Gd, Dd, Rd, Rd, Rd, Rd, Rd, Dd^Esd, Dd, Dd, Dd^Esd, Dd, Dd^Esd, Dd, Dd^Esd, Dd
Hhd, Hhd, Hhd, Gd, Rd, Rd, Rd, Gd^Edt, Hhd, Hhd, Gd, Gd^Es, Dd, Rd, Dd, Dd^Edp, Dd, Dd, Dd, Dd, Dd, Dd, Dd, Dd, Dd, Dd, Dd, Dd^Esd, Hd, Dd, Hd, Hd, Hd
Gd, Rd, Rd, Rd, Dd, Rd, Dd, Dd^Edp, Dd, Dd, Dd, Dd, Dd, Dd^Edp, Dd, Dd, Dd, Dd^Esd, Dd, Cd^Vda, Hd, Dd, Dd, Dd, Dd, Dd, Dd, Dd, Cd^Vda, Hd, Hd, Hd, Hd
Dd, Dd, Dd, Dd, Dd, Dd, Cd^Vda, Dd^Edpp, Dd^Esd, Dd, Dd^Edp, Dd, Dd, Dd, Dd^Cov, Dd^Cov, Dd^Cov, Dd^Esd, Dd, Hd, Hd, Hd, Hd, Hd, Hd, Hd, Hd, Dd, Dd, Dd, Dd, Hd, Dd
Dd, Dd, Dd, Dd, Hd, Dd, Hd, Dd, Hd, Hd, Hd, Dd^Edpp, Dd, Dd, Dd^Cov, 8 Kd^Vda, Dd^Cov, Dd^Esd, Dd, Dd, Dd, Dd^Edpp, Dd, Hd, Dd, Hd, Dd, Dd, Dd, Dd, Dd, Dd^Edp, Dd^Edp
Dd^Esd, Dd^Esd, Dd, Dd, Dd, Hd, Dd, Hd, Dd, Hd, Dd, Dd^Edpp, Dd, Dd, Dd, Dd, Dd^Esd, Dd, Dd, Dd, Dd^Edp, Dd, Dd, Dd, Dd, Dd, Dd, Dd, Dd^Esd, Dd, Dd^Esd, Dd, Dd^Edpp
